WWWWWWWWWWWWWWWWWW
W.......WW......*W
W.WW..........WW.W
W......WWWW......W
WW......WW......WW
WWWW..........WWWW
W....W......W....W
W....WW....WW....W
W................W
W...W...WWWWW....W
W.W.W...W KCW....W
W.......W---W..W.W
W...F............W
W...WWW....WWW...W
W....W..WW..W....W
W................W
W*WW..........WW.W
W......W...W.....W
W.....WW...WW....W
W....F...........W
W*WW....WW....WW*W
W.W..WW....WW..W.W
W........P......FW
WWWWWWWWWWWWWWWWWW