WWWWWWWWWWWWWWWWWW
W.*..W.......W.*.W
W........F.......W
W....WWWWWW...W..W
W.W..W   IW......W
W....W----W.WW...W
WWW....F....W.W..W
WFW.WWWWW...W....W
W.W.........W.*..W
W.W..WWWW...W.W..W
W...........W....W
W..WWWWWW.W.W.W..W
W................W
W.W..W..W..W..W..W
W....W.W.........W
W.W..W*W.....WW..W
W.W..W.W.W....*..W
W...W..W.....WW..W
WWW.....P....WW..W
W...W.WWWW.W.....W
W..WW...F..WW....W
W.W.....WW...W...W
WW....W.*..W....*W
WWWWWWWWWWWWWWWWWW
